49 49 49 49 49 49 49 49 49 49 49 49 49 49 49 49
49 49 49 49 49 49 49 49 49 49 11 11 11 11 11 49
49 49 49 49 49 49 49 49 49 11 11 11 11 11 11 49
49 49 49 49 49 49 49 49 49 49 11 11 11 11 49 49
49 49 49 49 49 49 49 49 49 49 49 49 49 49 49 49
49 49 49 49 10 10 10 10 49 49 49 49 49 49 49 49
49 49 49 49 10 10 10 10 49 49 49 49 49 49 49 49
49 49 49 49 10 10 10 10 49 49 49 49 49 49 49 49
49 49 49 49 49 49 49 49 49 49 49 49 49 49 49 49
49 49 49 49 49 49 49 49 49 49 49 49 49 49 49 49
49 49 49 49 49 49 49 49 49 49 49 49 49 49 49 49
49 49 49 49 49 49 49 49 49 49 49 49 49 49 49 49
49 49 49 49 49 49 49 49 49 49 49 49 49 49 49 49
49 49 49 49 49 49 49 49 49 49 49 49 49 49 49 49
49 10 49 49 49 49 49 49 49 49 49 49 49 49 49 49
10 10 10 10 49 49 49 49 49 49 49 49 49 49 49 49
10 10 10 49 49 49 49 49 49 49 49 49 49 49 49 49
49 10 49 49 49 49 49 49 49 49 10 10 10 10 10 10
49 49 49 49 49 49 49 49 49 49 10 10 10 10 10 10
49 49 49 49 11 11 11 11 49 10 10 10 10 10 10 10